111111111111111
111111CCCCC1111
11CCCCC111C1111
111111C1CCC1111
11111CC111C1111
111C1C1111C1111
1P00000C00000E1
111111111111111
