1111111111111111111111111111111111111111111111111111111111
1CCCCCCCCCCCCCCCCCCCCCCCCCCCCCCCCCCCCCCCCCCCCCCCCCCCCCCCC1
1C0000C0000C0000C0000C0000C0000C0000C0000C0000C0000C0000C1
1C0110C0000C0110C0000C0110C0000C0110C0000C0110C0000C0110C1
1C0000C0000C0000C0000C0000C0000C0000C0000C0000C0000C0000C1
1CCCCCCCCCCCCCCCCCCCCCCCCCCCCCCCCCCCCCCCCCCCCCCCCCCCCCCCC1
1C0000C0000C0000C0000C0000C0000C0000C0000C0000C0000C0000C1
1C0000C0110C0000C0110C0000C0110C0000C0110C0000C0110C0000C1
1C0000C0000C0000C0000C0000C0000C0000C0000C0000C0000C0000C1
1CCCCCCCCCCCCCCCCCCCCCCCCCCCCCCCCCCCCCCCCCCCCCCCCCCCCCCCC1
1C0000C0000C0000C0000C0000C0000C0000C0000C0000C0000C0000C1
1C0110C0000C0110C0000C0110C0000C0110C0000C0110C0000C0110C1
1C0000C0000C0000C0000C0000C0000C0000C0000C0000C0000C0000C1
1CCCCCCCCCCCCCCCCCCCCCCCCCCCCCCCCCCCCCCCCCCCCCCCCCCCCCCCC1
1C0000C0000C0000C0000C0000C0000C0000C0000C0000C0000C0000C1
1C0000C0110C0000C0110C0PE0C0110C0000C0110C0000C0110C0000C1
1C0000C0000C0000C0000C0000C0000C0000C0000C0000C0000C0000C1
1CCCCCCCCCCCCCCCCCCCCCCCCCCCCCCCCCCCCCCCCCCCCCCCCCCCCCCCC1
1C0000C0000C0000C0000C0000C0000C0000C0000C0000C0000C0000C1
1C0110C0000C0110C0000C0110C0000C0110C0000C0110C0000C0110C1
1C0000C0000C0000C0000C0000C0000C0000C0000C0000C0000C0000C1
1CCCCCCCCCCCCCCCCCCCCCCCCCCCCCCCCCCCCCCCCCCCCCCCCCCCCCCCC1
1C0000C0000C0000C0000C0000C0000C0000C0000C0000C0000C0000C1
1C0000C0110C0000C0110C0000C0110C0000C0110C0000C0110C0000C1
1C0000C0000C0000C0000C0000C0000C0000C0000C0000C0000C0000C1
1CCCCCCCCCCCCCCCCCCCCCCCCCCCCCCCCCCCCCCCCCCCCCCCCCCCCCCCC1
1111111111111111111111111111111111111111111111111111111111
