11111111111111111111111111111111111111111111111111111111111111111111
100C0000C0000C000C0000C0000C000C0000C000C0000C0000C00001100001100001
100C0000C0000C000C0000C0000C000C0000C000C0000C0000C00001100001100001
100C0000C0000C000C0000C0000C000C0000C000C0000C0000C00001100001100001
100C0000C0000C000C0000C0000C000C0000C000C0000C0000C00001100001100001
100C0000C0000C000C0000C0000C000C0000C000C0000C0000C00001100001100001
100C0000C0000C000C0000C0000C000C0000C000C0000C0000C00001100001100001
100C0000C0000C000C0000C0000C000C0000C000C0000C0000C00001100001100001
100C0000C0000C000C0000C0000C000C0000C000C0000C0000C00001100001100001
100C0000C0000C000C0000C0000C000C0000C000C0000C0000C00001100001100001
100C0000C0000C000C0000C0000C000C0000C000C0000C0000C00001100001100001
100C0000C0000C000C0000C0000C000C0000C000C0000C0000C00001100001100001
1E0C0000C0000C000C0000C0000C000C0000C000C0000C0000C00001100001100001
100C0000C0000C000C0000C0000C000C0000C000C0000C0000C00001100001100001
100C0000C0000C000C0000C0000C000C0000C000C0000C0000C000P1100001100001
100C0000C0000C000C0000C0000C000C0000C000C0000C0000C00001100001100001
100C0000C0000C000C0000C0000C000C0000C000C0000C0000C00001100001100001
100C0000C0000C000C0000C0000C000C0000C000C0000C0000C00001100001100001
100C0000C0000C000C0000C0000C000C0000C000C0000C0000C00001100001100001
100C0000C0000C000C0000C0000C000C0000C000C0000C0000C00001100001100001
100C0000C0000C000C0000C0000C000C0000C000C0000C0000C00001100001100001
100C0000C0000C000C0000C0000C000C0000C000C0000C0000C00001100001100001
100C0000C0000C000C0000C0000C000C0000C000C0000C0000C00001100001100001
100C0000C0000C000C0000C0000C000C0000C000C0000C0000C00001100001100001
100C0000C0000C000C0000C0000C000C0000C000C0000C0000C00001100001100001
100C0000C0000C000C0000C0000C000C0000C000C0000C0000C00001100001100001
100C0000C0000C000C0000C0000C000C0000C000C0000C0000C00001100001100001
100C0000C0000C000C0000C0000C000C0000C000C0000C0000C00001100001100001
11111111111111111111111111111111111111111111111111111111111111111111
