1c111111
1PEC1111
1000n111
11111111
